11111111
10000001
10011101
10011001
100111D1
10000001
10T000N1
11111111

