NO ./res/Wall-000.xpm
EA ./res/Wall-003.xpm
SO ./res/Wall-002.xpm
F 220,100,0

WE ./res/Wall-001.xpm
C 225,30,0

11111111
10000001
10011101
10011001
10011101
100000011
100000N1
11111111
