1111111111
1000000001
1001111001
1001  1001
10011111D11
1000000001
10T00 0001
10000000N1
1111111111
