NO ./res/Wall-000.xpm
EA ./res/Wall-003.xpm
SO ./res/Wall-002.xpm
WE ./res/Wall-001.xpm
F 85,85,85
C 50,50,50

1111111111111111111111111
1000000000000000000000001
1000000000000000000000001
1000000000000000000000001
1000000000000000000000001
1000000000000000000000001
1000000000000000000000001
1000000000000000000000001
1000000000000000000000001
1000000000111100000000001
1000000000000000000000001
100000000011110000E000001
1000000000000000000000001
1000000000111100000000001
1000000000000000000000001
1111111111111111111111111
