NO ./res/Wall-000.xpm
EA ./res/Wall-003.xpm
SO ./res/Wall-002.xpm
WE ./res/Wall-001.xpm
F 85,85,85
C 50,50,50

111111
100001
100001
100001
100001
100S01
111111
